R 900 600
NO ./textures/bricks.xpm
SO ./textures/woodreal.xpm
EA ./textures/blocks.xpm
WE ./textures/stonewallblue.xpm
S ./textures/catsmall.xpm
C 141, 209, 255
F 38, 124, 181

         11111111
11111111112000001
1000000000000W201
10002000010000001
10000000011101111
1000002001 101
1000000001 101
11011111111101
12000111110001
10000000000201
11111111111111