R 1250 1000
NO ./textures/multibrick.xpm
SO ./textures/mossy.xpm
EA ./textures/hexgreen.xpm
WE ./textures/redgreycheck.xpm
S ./textures/sprite_1.xpm
C 32, 32, 32
F 50, 0, 0

111111111111111111111
100000000000022000001
100000000000000000001
100000020000000000001
100000020000000000001
100000000000000000001
1000000000000000000011111111111
1000000002220000000000000000001
1000000011111000000000000000001
1000000011 11000000201000000001
10000000111110000002010000W0001
1000000022222000000201000000001
1000000000000000000000000000001
1001111000000000000011111111111
100100100000001111001
100100000000001001001
100100100000002001001
100111100000001111001
100000000000000000021
111111111111111111111